{
    "tileset_id": "tileset_01",
    "scale_factor": 3,
    "scaled_tile_width": 48,
    "scaled_tile_height": 48,
    "num_of_cols": 32,
    "num_of_rows": 20,
    "tile_layers": {
        "background": [
            [
                [ 0,  0,  0,  0,  0,  0,  0,  0,  0,  0,  0,  0,  0,  0,  0,  0,  0,  0,  0,  0,  0,  0,  0,  0,  0,  0,  0,  0,  0,  0,  0,  0],
                [ 0,  0,  0,  0,  0,  0,  0,  0,  0,  0,  0,  0,  0,  0,  0,  0,  0,  0,  0,  0,  0,  0,  0,  0,  0,  0,  0,  0,  0,  0,  0,  0],
                [ 0,  0,  0,  0,  0,  0,  0,  0,  0,  0,  0,  0,  0,  0,  0,  0,  0,  0,  0,  0,  0,  0,  0,  0,  0,  0,  0,  0,  0,  0,  0,  0],
                [32, 33,  0,  0,  0,  0,  0,  0,  0,  0,  0,  0,  0,  0,  0,  0,  0,  0,  0,  0,  0,  0,  0,  0,  0,  0,  0,  0,  0,  0,  0,  0],
                [42, 43,  0,  0,  0,  0,  0,  0,  0,  0,  0,  0,  0,  0,  0,  0,  0,  0,  0,  0,  0,  0,  0,  0,  0,  0,  0,  0,  0,  0,  0,  0],
                [ 0,  0,  0,  0,  0,  0,  0,  0,  0,  0,  0,  0,  0,  0,  0,  0,  0,  0,  0,  0,  0,  0,  0,  0,  0,  0,  0,  0,  0,  0,  0,  0],
                [ 0,  0,  0,  0,  0,  0,  0,  0,  0,  0,  0,  0,  0,  0,  0,  0,  0,  0,  0,  0,  0,  0,  0,  0,  0,  0,  0,  0,  0,  0,  0,  0],
                [ 0,  0,  0,  0,  0,  0,  0, 42, 33,  0,  0,  0,  0,  0,  0,  0,  0,  0,  0,  0,  0,  0,  0,  0,  0,  0,  0,  0,  0,  0,  0,  0],
                [ 0,  0,  0,  0,  0, 35, 42, 42, 43,  0,  0,  0,  0,  0,  0,  0,  0,  0,  0,  0,  0,  0,  0,  0,  0,  0,  0,  0,  0,  0,  0,  0],
                [ 0,  0,  0, 42, 44, 45, 42, 34, 53,  0,  0,  0,  0,  0,  0,  0, 31, 33,  0,  0,  0,  0,  0,  0,  0,  0,  0,  0,  0,  0,  0,  0],
                [ 0,  0,  0, 42, 42, 42, 34, 53,  0,  0,  0,  0,  0,  0,  0, 31, 45, 43,  0,  0,  0,  0,  0,  0,  0,  0,  0,  0,  0,  0,  0,  0],
                [ 0,  0,  0, 42, 34, 52, 53,  0,  0,  0,  0,  0,  0,  0,  0, 41,  0,  0,  0,  0,  0,  0,  0,  0,  0,  0,  0,  0,  0,  0,  0,  0],
                [ 0,  0,  0, 42, 44, 33,  0,  0,  0,  0,  0,  0,  0,  0,  0,  0,  0,  0,  0,  0,  0,  0,  0,  0,  0,  0,  0,  0,  0,  0,  0,  0],
                [ 0,  0,  0, 42, 42, 43,  0,  0,  0,  0,  0,  0,  0,  0,  0, 42, 42, 42, 44,  0,  0,  0,  0,  0,  0,  0,  0,  0,  0,  0,  0,  0],
                [ 0,  0,  0,  0, 42, 43,  0,  0,  0,  0,  0,  0,  0,  0,  0, 51, 35, 42, 44, 32, 33,  0,  0,  0,  0,  0,  0,  0,  0,  0,  0,  0],
                [ 0,  0,  0,  0,  0,  0,  0,  0,  0,  0,  0, 31, 33,  0,  0,  0, 41, 42, 42, 42, 44, 32, 33,  0,  0,  0,  0,  0,  0,  0,  0,  0],
                [ 0,  0,  0,  0,  0,  0,  0,  0,  0,  0,  0, 42, 43,  0,  0,  0, 41,  0,  0,  0, 42, 42, 44, 33,  0,  0,  0,  0,  0,  0,  0,  0],
                [ 0,  0,  0,  0,  0,  0,  0,  0,  0,  0, 42, 42, 43,  0,  0,  0, 41, 42,  0,  0,  0,  0,  0,  0,  0,  0,  0,  0,  0,  0,  0,  0],
                [ 0,  0,  0,  0,  0,  0,  0,  0,  0,  0, 42, 34, 53,  0,  0,  0, 51, 52,  0,  0,  0,  0,  0,  0,  0,  0,  0,  0,  0,  0,  0,  0],
                [ 0,  0,  0,  0,  0,  0,  0,  0,  0,  0, 42, 43,  0,  0,  0,  0,  0,  0,  0,  0,  0,  0,  0,  0,  0,  0,  0,  0,  0,  0,  0,  0]
            ],
            [
                [ 0,  0,  0,  0,  0,  0,  0,  0,  0,  0,  0,  0,  0,  0,  0,  0,  0,  0,  0,  0,  0,  0,  0,  0,  0,  0,  0,  0,  0,  0,  0,  0],
                [ 0,  0,  0,  0,  0,  0,  0,  0,  0,  0,  0,  0,  0,  0,  0,  0,  0,  0,  0,  0,  0,  0,  0,  0,  0,  0,  0,  0,  0,  0,  0,  0],
                [ 0,  0,  0,  0,  0,  0,  0,  0,  0,  0,  0,  0,  0,  0,  0,  0,  0,  0,  0,  0,  0,  0,  0,  0,  0,  0,  0,  0,  0,  0,  0,  0],
                [ 0,  0,  0,  0,  0,  0,  0,  0,  0,  0,  0,  0,  0,  0,  0,  0,  0,  0,  0,  0,  0,  0,  0,  0,  0,  0,  0,  0,  0,  0,  0,  0],
                [ 0, 56, 57, 58,  0,  0,  0,  0,  0,  0,  0,  0,  0,  0,  0,  0,  0,  0,  0,  0,  0,  0,  0,  0,  0,  0,  0,  0,  0,  0,  0,  0],
                [ 0,  0,  0,  0,  0,  0,  0,  0,  0,  0,  0,  0,  0,  0,  0,  0,  0,  0,  0,  0,  0,  0,  0,  0,  0,  0,  0,  0,  0,  0,  0,  0],
                [ 0,  0,  0,  0,  0,  0,  0,  0,  0,  0,  0,  0,  0,  0,  0,  0,  0,  0,  0,  0,  0,  0,  0,  0,  0,  0,  0,  0,  0,  0,  0,  0],
                [ 0,  0,  0,  0,  0,  0,  0,  0,  0,  0,  0,  0,  0,  0,  0,  0,  0,  0,  0,  0,  0,  0,  0,  0,  0,  0,  0,  0,  0,  0,  0,  0],
                [ 0,  0,  0,  0,  0,  0,  0,  0,  0,  0,  0,  0,  0,  0,  0,  0,  0,  0,  0,  0,  0,  0,  0,  0,  0,  0,  0,  0,  0,  0,  0,  0],
                [ 0,  0,  0,  0,  0,  0,  0,  0,  0,  0,  0,  0,  0,  0,  0,  0,  0,  0,  0,  0,  0,  0,  0,  0,  0,  0,  0,  0,  0,  0,  0,  0],
                [ 0,  0,  0,  0,  0,  0,  0,  0,  0,  0,  0,  0,  0,  0,  0,  0, 56, 58,  0,  0,  0,  0,  0,  0,  0,  0,  0,  0,  0,  0,  0,  0],
                [ 0,  0,  0,  0,  0,  0,  0,  0,  0,  0,  0,  0,  0,  0,  0,  0,  0,  0,  0,  0,  0,  0,  0,  0,  0,  0,  0,  0,  0,  0,  0,  0],
                [ 0,  0,  0,  0,  0,  0,  0,  0,  0,  0,  0,  0,  0,  0,  0,  0,  0,  0,  0,  0,  0,  0,  0,  0,  0,  0,  0,  0,  0,  0,  0,  0],
                [ 0,  0,  0,  0,  0,  0,  0,  0,  0,  0,  0,  0,  0,  0,  0,  0,  0,  0,  0,  0,  0,  0,  0,  0,  0,  0,  0,  0,  0,  0,  0,  0],
                [ 0,  0,  0,  0,  0,  0,  0,  0,  0,  0,  0,  0,  0,  0,  0,  0,  0,  0,  0,  0,  0,  0,  0,  0,  0,  0,  0,  0,  0,  0,  0,  0],
                [ 0,  0,  0,  0,  0,  0,  0,  0,  0,  0,  0, 47,  0,  0,  0,  0, 49, 56, 57, 58,  0,  0,  0,  0, 56, 58,  0, 37, 39, 38, 39, 40],
                [ 0,  0,  0,  0,  0,  0,  0,  0,  0,  0,  0, 48, 48, 48, 48, 48, 48,  0,  0,  0,  0, 50, 50,  0,  0,  0,  0,  0,  0,  0,  0,  0],
                [ 0,  0,  0,  0,  0,  0,  0,  0,  0,  0,  0,  0,  0,  0,  0,  0,  0,  0,  0,  0,  0,  0,  0,  0,  0,  0,  0,  0,  0,  0,  0,  0],
                [ 0,  0,  0,  0,  0,  0,  0,  0,  0,  0,  0,  0,  0,  0,  0,  0,  0,  0,  0,  0,  0,  0,  0,  0,  0,  0,  0,  0,  0,  0,  0,  0],
                [ 0,  0,  0,  0,  0,  0,  0,  0,  0,  0,  0,  0,  0,  0,  0,  0,  0,  0,  0,  0,  0,  0,  0,  0,  0,  0,  0,  0,  0,  0,  0,  0]
            ]
        ],
        "foreground": [
            [
                [ 0,  0,  0,  0,  0,  0,  0,  0,  0,  0,  0,  0,  0,  0,  0,  0,  0,  0,  0,  0,  0,  0,  0,  0,  0,  0,  0,  0,  0,  0,  0,  0],
                [ 0,  0,  0,  0,  0,  0,  0,  0,  0,  0,  0,  0,  0,  0,  0,  0,  0,  0,  0,  0,  0,  0,  0,  0,  0,  0,  0,  0,  0,  0,  0,  0],
                [ 0,  0,  0,  0,  0,  0,  0,  0,  0,  0,  0,  0,  0,  0,  0,  0,  0,  0,  0,  0,  0,  0,  0,  0,  0,  0,  0,  0,  0,  0,  0,  0],
                [ 0,  0,  0,  0,  0,  0,  0,  0,  0,  0,  0,  0,  0,  0,  0,  0,  0,  0,  0,  0,  0,  0,  0,  0,  0,  0,  0,  0,  0,  0,  0,  0],
                [ 0,  0,  0,  0,  0,  0,  0,  0,  0,  0,  0,  0,  0,  0,  0,  0,  0,  0,  0,  0,  0,  0,  0,  0,  0,  0,  0,  0,  0,  0,  0,  0],
                [ 2,  4,  2,  4,  2,  2,  3,  0,  0,  0,  0,  0,  0,  0,  0,  0,  0,  0,  0,  0,  0,  0,  0,  0,  0,  0,  0,  0,  0,  0,  0,  0],
                [12, 12, 12, 12, 12, 12, 15,  2,  3,  0,  0,  0,  0,  0,  0,  0,  0,  0,  0,  0,  0,  0,  0,  0,  0,  0,  0,  0,  0,  0,  0,  0],
                [12, 24, 12, 12, 12, 12, 12,  5, 23,  0,  0,  0,  0,  0,  0,  0,  0,  0,  0,  0,  0,  0,  0,  0,  0,  0,  0,  0,  0,  0,  0,  0],
                [12, 12, 12, 12,  5, 22, 22, 23,  0,  0,  0,  0,  0,  0,  0,  0,  0,  0,  0,  0,  0,  0,  0,  0,  0,  0,  0,  0,  0,  0,  0,  0],
                [12, 12, 12,  5, 23,  0,  0,  0,  0,  0,  0,  0,  0,  0,  0,  0,  0,  0,  0,  0,  0,  0,  0,  0,  0,  0,  0,  0,  0,  0,  0,  0],
                [12, 12, 12, 13,  0,  0,  0,  0,  0,  0,  0,  0,  0,  0,  0,  0,  0,  0,  0,  0,  0,  0,  0,  0,  0,  0,  0,  0,  0,  0,  0,  0],
                [12, 12, 24, 13,  0,  0,  0,  0,  0,  0,  0,  0,  0,  0,  0,  1,  4,  2,  3,  0,  0,  0,  0,  0,  0,  0,  0,  0,  0,  0,  0,  0],
                [12, 12, 14, 13,  0,  0,  0,  0,  0,  0,  0,  0,  0,  0,  1,  7, 24, 12, 13,  0,  0,  0,  0,  0,  0,  0,  0,  0,  0,  0,  0,  0],
                [12, 12, 12, 13,  0,  0,  0,  0,  0,  0,  0,  0,  0,  0, 21, 22, 22, 22, 23,  0,  0,  0,  0,  0,  0,  0,  0,  0,  0,  0,  0,  0],
                [12, 12, 12, 15,  3,  0,  0,  0,  0,  0,  0,  0,  0,  0,  0,  0,  0,  0,  0,  0,  0,  0,  0,  0,  0,  0,  0,  0,  0,  0,  0,  0],
                [12, 12, 12, 12, 15,  2,  2,  3,  0,  0,  0,  0,  0,  0,  0,  0,  0,  0,  0,  0,  0,  0,  0,  0,  0,  0,  0,  0,  0,  0,  0,  0],
                [12, 12, 12, 12, 12, 24, 12, 15,  4,  2,  2,  3,  0,  0,  0,  0,  1,  2,  2,  2,  3,  0,  0,  1,  4,  2,  2,  2,  2,  2,  2,  2],
                [12, 12, 12, 12, 12, 12, 12, 12, 12, 12,  5, 23,  0,  0,  0,  0, 21,  6, 14, 24, 15,  2,  2,  7, 12, 12, 12, 12, 12, 24, 12, 12],
                [12, 12, 12, 24, 12, 12, 12, 12, 14, 12, 13,  0,  0,  0,  0,  0,  0, 11, 12, 12, 12, 12, 12, 12, 12, 12, 12, 12, 12, 12, 12, 12],
                [12, 12, 12, 12, 12, 12, 12, 12, 12, 12, 13,  0,  0,  0,  0,  0,  0, 11, 12, 12, 12, 12, 12, 12, 12, 12, 12, 12, 12, 12, 12, 12]
            ],
            [
                [ 0,  0,  0,  0,  0,  0,  0,  0,  0,  0,  0,  0,  0,  0,  0,  0,  0,  0,  0,  0,  0,  0,  0,  0,  0,  0,  0,  0,  0,  0,  0,  0],
                [ 0,  0,  0,  0,  0,  0,  0,  0,  0,  0,  0,  0,  0,  0,  0,  0,  0,  0,  0,  0,  0,  0,  0,  0,  0,  0,  0,  0,  0,  0,  0,  0],
                [ 0,  0,  0,  0,  0,  0,  0,  0,  0,  0,  0,  0,  0,  0,  0,  0,  0,  0,  0,  0,  0,  0,  0,  0,  0,  0,  0,  0,  0,  0,  0,  0],
                [ 0,  0,  0,  0,  0,  0,  0,  0,  0,  0,  0,  0,  0,  0,  0,  0,  0,  0,  0,  0,  0,  0,  0,  0,  0,  0,  0,  0,  0,  0,  0,  0],
                [ 0, 18, 18,  0, 18, 18,  0,  0,  0,  0,  0,  0,  0,  0,  0,  0,  0,  0,  0,  0,  0,  0,  0,  0,  0,  0,  0,  0,  0,  0,  0,  0],
                [29, 28, 28, 29, 28, 29, 30,  0,  0,  0,  0,  0,  0,  0,  0,  0,  0,  0,  0,  0,  0,  0,  0,  0,  0,  0,  0,  0,  0,  0,  0,  0],
                [ 0,  0,  0,  0,  0,  0,  0,  0,  0,  0,  0,  0,  0,  0,  0,  0,  0,  0,  0,  0,  0,  0,  0,  0,  0,  0,  0,  0,  0,  0,  0,  0],
                [ 0,  0,  0,  0,  0,  0,  0,  0,  0,  0,  0,  0,  0,  0,  0,  0,  0,  0,  0,  0,  0,  0,  0,  0,  0,  0,  0,  0,  0,  0,  0,  0],
                [ 0,  0,  0,  0,  0,  0,  0,  0,  0,  0,  0,  0,  0,  0,  0,  0,  0,  0,  0,  0,  0,  0,  0,  0,  0,  0,  0,  0,  0,  0,  0,  0],
                [ 0,  0,  0,  0,  0,  0,  0,  0,  0,  0,  0,  0,  0,  0,  0,  0,  0,  0,  0,  0,  0,  0,  0,  0,  0,  0,  0,  0,  0,  0,  0,  0],
                [ 0,  0,  0,  0,  0,  0,  0,  0,  0,  0,  0,  0,  0,  0,  0,  0, 18, 18, 20,  0,  0,  0,  0,  0,  0,  0,  0,  0,  0,  0,  0,  0],
                [ 0,  0,  0,  0,  0,  0,  0,  0,  0,  0,  0,  0,  0,  0, 17, 27, 29, 29, 30,  0,  0,  0,  0,  0,  0,  0,  0,  0,  0,  0,  0,  0],
                [ 0,  0,  0,  0,  0,  0,  0,  0,  0,  0,  0,  0,  0,  0, 27, 30,  0,  0,  0,  0,  0,  0,  0,  0,  0,  0,  0,  0,  0,  0,  0,  0],
                [ 0,  0,  0,  0,  0,  0,  0,  0,  0,  0,  0,  0,  0,  0,  0,  0,  0,  0,  0,  0,  0,  0,  0,  0,  0,  0,  0,  0,  0,  0,  0,  0],
                [ 0,  0,  0,  0,  0,  0,  0,  0,  0,  0,  0,  0,  0,  0,  0,  0,  0,  0,  0,  0,  0,  0,  0,  0,  0,  0,  0,  0,  0,  0,  0,  0],
                [ 0,  0,  0,  0,  0,  0,  0,  0, 18, 18, 18,  0,  0,  0,  0,  0,  0, 18, 18, 18, 20,  0,  0, 17, 18, 18, 18,  0, 18, 18,  0, 18],
                [ 0,  0,  0,  0,  0,  0,  0, 27, 28, 29, 29, 30,  0,  0,  0,  0, 27, 28, 28, 29, 30,  0,  0, 27, 29, 28, 29, 29, 28, 29, 28, 29],
                [ 0,  0,  0,  0,  0,  0,  0,  0,  0,  0,  0,  0,  0,  0,  0,  0,  0,  0,  0,  0,  0,  0,  0,  0,  0,  0,  0,  0,  0,  0,  0,  0],
                [ 0,  0,  0,  0,  0,  0,  0,  0,  0,  0,  0,  0,  0,  0,  0,  0,  0,  0,  0,  0,  0,  0,  0,  0,  0,  0,  0,  0,  0,  0,  0,  0],
                [ 0,  0,  0,  0,  0,  0,  0,  0,  0,  0,  0,  0,  0,  0,  0,  0,  0,  0,  0,  0,  0,  0,  0,  0,  0,  0,  0,  0,  0,  0,  0,  0]
            ]
        ]
    },
    "object_layers": {
        "background": [],
        "foreground": []
    },
    "parallax_layers": {
        "background": [
            {
                "img_id": "CloudsBack",
                "scale_factor": 3,
                "scroll_speed": -0.178,
                "scroll_type": "independent",
                "depth": 0
            },
            {
                "img_id": "CloudsFront",
                "scale_factor": 3,
                "scroll_speed": -0.237,
                "scroll_type": "independent",
                "depth": 1
            },
            {
                "img_id": "MountainsBack",
                "scale_factor": 3,
                "scroll_speed": 0.5,
                "scroll_type": "dependent",
                "depth": 2
            },
            {
                "img_id": "MountainsFront",
                "scale_factor": 3,
                "scroll_speed": 0.7,
                "scroll_type": "dependent",
                "depth": 3
            }
        ],
        "foreground": []
    }
}